###########
#*S**#***##
#*********#
##*******##
#***##*##*#
#*G*##****#		
###########